CCCCCCCC
CCAACCCC
CAAAAAAC
CCCCCCCC
#
AACAAAAA
AABBAAAA
ABBBBBBA
AAAAAAAA
#